9,15
4,3
#########
#  III !#
#########
#### ####
#### ####
#g   ####
#### ####
####G####
#t     t#
#       #
#       #
#t     t#
#### ####
#### ####
#########
tokenDoor,4,12,4
enemyStraight,1,10,1,RIGHT
teleporter,1,1,4,13