33,15
1,1
#################################
#      S     #                  #
############ ############B#######
#t      #### #          # #     #
#  ###  #### #          #w#     #
#  ###       G         f###     #
#  ###  #### ####################
#t      #### #b                g#
############ #                  #
#         ## #########B##########
############ ######### ##########
#                            FW #
#                            FW #
#b                           FW!#
#################################
tokenDoor,22,10,2
enemyStraight,31,1,1,LEFT
enemyStraight,3,12,1,UP
enemyStraight,18,12,1,DOWN
enemyStraight,18,10,1,UP
enemyStraight,30,10,1,DOWN
enemyWall,3,3,1,RIGHT
teleporter,14,3,14,1